1XXXXXXXXXXXXXXXXXX1
1XXXXXXXXXXXXXXXXXX1
1XXXXXXXXXXXXXXXXXX1
1XXXX1XXXXXXXXXXXXX1
1XXX1X1XXXXXXXXXXXX1
1PXXXXXXXXXXXXXXXXX1
111111111S1111111111
11111111111111111111
11111111111111111111
11111111111111111111