1000000000000000000000000000000000000000000000000000000000001111
1000000000000000000000000000000000000000000000000000000000001111
1000000000000000000000000000000000000000000000000000000000001111
1000000000000000000000000000000000000000000000000000000000001111
1000000000000000000000000000000000000000000000000000000000001111
1000000000000000000000000000000000000000000000000000000000001111
100L00000L000000L00000L000000L00000L000000L00000L00000L000001111
1000000000000000000000000000000000000000000000000000000000001111
1000000000000000000000000000000111111100000000000000000000001111
1000000000000111111000000000001000000000000101010101000000001111
1000000001000000000000000000010000000000000000000000000001111111
100P000000000000000000000000100000000000000000000000000000001111
1111111111111111111111S0S11111111111SS11111111111111111111111111
11111111111111111111111K1111111111111111111111111111111111111111
1111111111111111111111101111111111111111111111111111111111111111
1111111111111111111111101111111111111111111111111111111111111111
1111111111111111111111111111111111111111111111111111111111111111